0 2 0 0 0
6 6 6 3 6
9 0 0 0 0
0 6 4 6 0
0 0 5 0 2