9 0 2 6 0 0 0 6 0 3
0 6 0 6 0 0 0 6 2 0
0 0 0 6 0 4 0 6 0 0
0 0 0 0 0 0 5 6 0 0
0 0 0 6 0 0 0 6 0 2
0 6 6 6 6 0 6 6 6 0
0 0 0 6 0 0 3 0 0 0
0 0 0 6 0 6 0 6 0 0
4 0 0 6 0 0 0 6 0 0
0 0 0 6 0 0 1 6 1 5